subject_id,browser_interactions,bad_data1,missed_choices,agency_trials,forgo_trials,total_stage_1,fast_choices,bad_data2,bad_data
11669,2,0,0,208,107,315,1,0,0
11671,2,0,0,315,0,315,0,0,0
11695,2,0,0,279,36,315,6,0,0
11701,2,0,0,201,114,315,0,0,0
11703,3,0,0,167,148,315,0,0,0
11709,2,0,0,227,88,315,0,0,0
11721,2,0,0,189,126,315,0,0,0
11724,2,0,0,240,75,315,0,0,0
11728,2,0,0,206,109,315,6,0,0
11738,2,0,5,177,133,310,1,0,0
11739,2,0,1,171,143,314,1,0,0
11740,2,0,0,306,9,315,24,0,0
11741,4,0,0,129,186,315,3,0,0
11742,2,0,0,310,5,315,99,1,1
11743,2,0,1,170,144,314,3,0,0
11745,2,0,0,312,3,315,0,0,0
11747,3,0,2,311,2,313,9,0,0
11750,2,0,1,26,288,314,4,0,0
11751,2,0,1,55,259,314,60,1,1
11752,2,0,0,311,4,315,16,0,0
11753,13,0,0,242,73,315,0,0,0
11754,5,0,5,147,163,310,63,1,1
11757,2,0,0,52,263,315,5,0,0
11758,2,0,0,174,141,315,0,0,0
11759,6,0,1,230,84,314,0,0,0
11762,2,0,0,249,66,315,10,0,0
11763,12,0,0,189,126,315,0,0,0
11764,2,0,1,207,107,314,0,0,0
11766,2,0,0,311,4,315,0,0,0
11777,4,0,1,5,309,314,6,0,0
11778,2,0,0,169,146,315,27,0,0
11802,2,0,0,196,119,315,0,0,0
11811,9,0,3,183,129,312,0,0,0
11813,2,0,0,177,138,315,0,0,0
11815,2,0,0,184,131,315,0,0,0
11816,5,0,12,165,138,303,4,0,0
11817,9,0,0,213,102,315,0,0,0
11823,2,0,0,183,132,315,0,0,0
11824,2,0,1,307,7,314,8,0,0
11832,2,0,0,289,26,315,1,0,0
11833,10,0,3,45,267,312,27,0,0
11837,3,0,1,242,72,314,0,0,0
11838,39,1,1,156,158,314,3,0,1
11839,3,0,0,314,1,315,0,0,0
11840,2,0,0,212,103,315,0,0,0
11841,2,0,0,314,1,315,0,0,0
11842,2,0,0,219,96,315,0,0,0
11884,6,0,2,172,141,313,0,0,0
11885,4,0,0,278,37,315,1,0,0
11895,7,0,0,257,58,315,0,0,0
11907,2,0,0,284,31,315,0,0,0
11908,2,0,0,117,198,315,12,0,0
11910,26,1,0,0,315,315,218,1,2
11911,14,0,6,29,280,309,90,1,1
11912,3,0,0,236,79,315,28,0,0
11913,3,0,0,0,315,315,18,0,0
11916,2,0,0,189,126,315,1,0,0
11917,2,0,0,223,92,315,0,0,0
11926,2,0,0,109,206,315,0,0,0
11933,2,0,0,219,96,315,0,0,0
11940,4,0,0,218,97,315,0,0,0
11945,2,0,1,184,130,314,1,0,0
11947,13,0,0,149,166,315,1,0,0
11948,25,1,0,310,5,315,0,0,1
11949,18,0,0,238,77,315,1,0,0
11958,2,0,3,255,57,312,22,0,0
11973,2,0,0,169,146,315,0,0,0
11985,2,0,0,208,107,315,18,0,0
11990,2,0,1,90,224,314,0,0,0
11992,2,0,1,131,183,314,0,0,0
11998,6,0,1,193,121,314,72,1,1
12002,2,0,0,144,171,315,0,0,0
12010,3,0,0,247,68,315,0,0,0
12012,2,0,0,315,0,315,0,0,0
12014,2,0,0,136,179,315,0,0,0
12024,2,0,0,155,160,315,0,0,0
12030,2,0,2,199,114,313,0,0,0
12032,8,0,0,234,81,315,89,1,1
12044,3,0,0,175,140,315,0,0,0
12049,2,0,2,272,41,313,0,0,0
12050,19,0,1,61,253,314,3,0,0
12052,2,0,0,249,66,315,0,0,0
12058,2,0,0,233,82,315,38,1,1
12060,3,0,0,110,205,315,0,0,0
12065,9,0,1,269,45,314,0,0,0
12070,2,0,0,166,149,315,1,0,0
12077,2,0,2,223,90,313,4,0,0
12079,2,0,1,165,149,314,0,0,0
12081,2,0,3,130,182,312,2,0,0
12088,9,0,0,135,180,315,0,0,0
12091,2,0,0,217,98,315,1,0,0
12098,4,0,0,210,105,315,0,0,0
12104,2,0,1,74,240,314,3,0,0
12107,12,0,0,173,142,315,0,0,0
12108,2,0,0,226,89,315,0,0,0
12111,2,0,0,278,37,315,9,0,0
12112,6,0,0,40,275,315,79,1,1
12118,2,0,0,146,169,315,0,0,0
12119,2,0,0,236,79,315,0,0,0
12122,2,0,0,226,89,315,0,0,0
12123,2,0,3,230,82,312,0,0,0
12124,2,0,0,252,63,315,0,0,0
12128,6,0,0,168,147,315,0,0,0
12129,2,0,1,103,211,314,1,0,0
12130,2,0,0,242,73,315,1,0,0
12132,2,0,0,246,69,315,1,0,0
12135,2,0,0,199,116,315,17,0,0
12137,4,0,0,162,153,315,0,0,0
12140,4,0,10,203,102,305,0,0,0
12142,2,0,0,197,118,315,0,0,0
12147,5,0,2,204,109,313,0,0,0
12148,2,0,0,265,50,315,0,0,0
12149,2,0,2,223,90,313,18,0,0
12166,4,0,0,293,22,315,0,0,0
12167,2,0,1,264,50,314,13,0,0
12170,2,0,0,182,133,315,0,0,0
12173,4,0,1,201,113,314,9,0,0
12183,2,0,0,211,104,315,0,0,0
12186,2,0,0,312,3,315,0,0,0
12189,2,0,0,292,23,315,2,0,0
12190,4,0,0,253,62,315,2,0,0
12191,9,0,1,303,11,314,4,0,0
12192,2,0,0,289,26,315,0,0,0
12195,2,0,0,184,131,315,0,0,0
12196,2,0,0,252,63,315,1,0,0
12198,2,0,0,280,35,315,0,0,0
12199,2,0,0,282,33,315,3,0,0
12203,2,0,0,251,64,315,0,0,0
12212,2,0,0,218,97,315,0,0,0
12216,2,0,1,135,179,314,0,0,0
12217,5,0,0,228,87,315,0,0,0
12218,4,0,0,195,120,315,0,0,0
12219,2,0,0,228,87,315,1,0,0
12242,2,0,0,261,54,315,0,0,0
12250,2,0,0,214,101,315,0,0,0
12257,2,0,0,270,45,315,0,0,0
12258,2,0,0,209,106,315,0,0,0
12259,5,0,0,309,6,315,10,0,0
12263,2,0,0,310,5,315,0,0,0
12269,3,0,0,26,289,315,78,1,1
12273,2,0,0,91,224,315,0,0,0
12274,2,0,1,283,31,314,0,0,0
12275,2,0,1,271,43,314,3,0,0
12276,2,0,0,299,16,315,4,0,0
12279,4,0,0,132,183,315,0,0,0
12281,2,0,0,37,278,315,0,0,0
12287,35,1,1,204,110,314,0,0,1
12290,5,0,0,146,169,315,0,0,0
12307,4,0,0,306,9,315,14,0,0
12310,2,0,0,262,53,315,0,0,0
12315,2,0,0,254,61,315,0,0,0
12332,2,0,0,237,78,315,1,0,0
12339,2,0,1,295,19,314,2,0,0
12342,2,0,0,189,126,315,0,0,0
12349,2,0,0,311,4,315,0,0,0
12378,2,0,0,292,23,315,1,0,0
12383,2,0,0,108,207,315,0,0,0
12385,2,0,0,159,156,315,2,0,0
12402,2,0,0,247,68,315,0,0,0
12441,4,0,0,67,248,315,0,0,0
